111111111111111111111111
110100111001111001001E11
11P10000C0000C0001000011
111111111111111111111111