111111111111111111111111
1101000C000E00000010C011
110100N00000010010101011
110000100000010010100011
110001110000010010100011
110100000000000010000011
110000100000000000001111
110100111001110010001011
110100111001110010001011
11P10000C0000C001000N011
111111111111111111111111
